AH G|jug
AH F|puff,enough,tough,rough,stuff,bluff
AE SH|cash,bash,trash,whiplash,smash,crash
AH D|wicked,mud,blood,blasted,acid,faded,loaded,wasted,naked,wanted,method,hundred,created,excited,hatred,frustrated,granted,existed,incorporated,stupid,started,selected,anointed,ended,arrested,waited,stated,blended,exploded,tasted,needed,landed,cheated,twisted,coated,collected,folded
L TH|health,wealth
AH B|rub,hub
N Z|greens,zones,conversations,john's,clemens,mountains,jones,klines,wagons,rines,scenes,reasons,jeans,queens,means,stones,veins,demons,questions,lines,remains,plains,brains,plans,headlines,guillotines,guns,ones,signs,headphones,orleans,machines,chains,connections,tombstones,bones,beans,burns,shines,screens,heavens,galleons,fountains,pains,havens,cushions,temptations,thorns,opinions,turns,man's,sins,emotions,runs,tunes,lanes,grins,ruins,suggestions,vibrations,elections,canes,operations,nations,lessons,possessions,handguns,bins,omens,resignations,treasons,vines,suspicions,omissions,frowns,begins,moans,horizons,violins
AH N|one,done,run,gun,none,bronson,question,imitation,slogan,fun,lincoln,occupation,nation,jackson,houston,clinton,badman,sensation,generation,weaken,sun,education,manson,danson,peon,son,motion,forsaken,texan,inception,allen,gallon,heaven,situation,brooklyn,direction,inspection,mackson,johnson,fashion,kitchen,mistaken,reason,goin',taken,woman,satisfaction,everyone,communication,motivation,thirty-one,undone,children,open,reflection,confusion,compassion,creation,season,illusion,emotion,forgotten,listen,deception,opinion,companion,confrontation,action,attraction,attention,frozen,ev'ryone,begun,anyone,women,dalton,won,mountain,lion,chicken,broken,happen,satan,intention,consolation,spoken,horizon,desecration,decision,confession,session,stolen,ignition,obsession,solution,misinformation,vision,notion,commotion,million,prison,weapon,caucasian,affection,vacation,ruin,fortune,station,policeman,dragon,wagon,seven,eleven,heroin,someone,religion,london,occasion,protection,dissection,seamen,pigeon,treason,certain,passion,combination,indecision,restitution,fusion,alien,infection,conversation,rotten,ocean,operation,liberation,eden,muffin,cousin,often,destruction,inspiration,good'n,prescription,written,reaction,self-destruction,construction,submission,abortion,madmen,celebration,destination,one',garden,elimination,reparation,damnation,innervision,postman,beethoven,lesson,tradition,superstition,mention,nonfiction,conclusion,possession,fallen,totalitarian,dungeon,profusion,odin,delusion,dominion,showman,golden,abandon,harridan,impression,titan,frighten,person,bun,anticipation,reputation,morrison,oxygen,beacon,poison,luncheon,american
AH M|some,from,em',dumb,magnum,umm,welcome,dum,rum,bum,hmmm,mmm,come,numb,system,freedom,mm,'em,problem,malcolm,slum,wisdom,hmm,mmm-hmmm,rhythm,impergium,ransom,drum,hummm,ummmmmmm,thumb,hum,bottom
AH L|article,model,bottle,popsicle,stable,able,unconventional,comprehendible,angel,capital,hershel,individual,saddle,battle,mescal,fertile,turtle,mental,central,carnival,beautiful,apparel,carol,emotional,evil,gentle,circle,table,deceitful,betrayal,skull,denial,cruel,trouble,bible,abel,fable,jungle,nickel,careful,people,riddle,possible,castle,little,predictable,simple,sequel,incomprehensible,cynical,cannibal,revival,needle,special,pistol,animal,middle,whistle,replaceable,potential,incredible,cradle,trial,comfortable,signal,faithful,pupil,apple,level,devil,sable,fistful,rattle,indestructible,disposable,habitual,rumble,tumble,metal,immortal,ramble,bicycle,diddle,fiddle,shuffle,confidential,plentiful,humble,chemical,physical,indivisible,ritual,anti-social,natural,unstable,eternal,cattle,medieval,cerebral,final,typical,miracle,pitiful,travel,impossible,manimal,terrible,gamble,purple,folderolderiddle,laurel,tickle,giggle,buckle,disciple,rival,double,eagle,gromble,survival,inevitable,vegetable
AH K|tow-truck,buck,cockblock,fuck,luck,truck,chuck,duck,suck,struck,stuck,tuck
L M|realm
N S|sense,dance,chance,presence,tense,residence,silence,vengeance,existence,guidance,innocence,once,circumstance,difference,nonsense,fence,since,patience,stance,acceptance,distance,romance,experience,independence,incantations,deliverance,heathens,trance,violence,evidence,repentance,decadence
IH TH|myth
AH V|love,of,above,dove,low-ow-ow-ow-ove,l-love,love'
AH T|butt,but,cut,gratiot,slut,wallet,what,pocket,blanket,harlot,spirit,minute,casket,basket,habit,picket,secret,pilot,shut,target,velvet,nut,bullet,bigot,corporate
AH S|us,abnoxious,madness,badness,quickness,uniqueness,careless,business,cautious,service,nervous,practice,cactus,loneliness,christmas,advantageous,greatness,darkness,timeless,spacious,jesus,promise,shallowness,precipice,fuss,bus,weakness,helpless,memphis,office,dangerous,contagious,happiness,nothingness,ruckus,emptiness,fearless,witness,texas,palace,axis,genius,restless,hopeless,focus,notice,meaningless,canvas,listless,circus
IH CH|bitch,biiiiiiiitch,ditch,manwich,sandwich,hitch,non-rich,witch,itch
N K|chipmunk
AH P|up,sup,pup,dup,makeup,shakeup
N D|behind,around,ground,sound,pound,stand,hand,land,mind,fiend,round,weekend,kind,homeland,end,understand,thyland,island,and,grand,friend,'round,stoned,grande,comprehend,wind,found,find,burned,blind,underground,happened,bound,pretend,sinned,sand,pined,trend,hound,greyhound,band,southland,undertand,boyfriend,girlfriend,opened,unkind,planned,lend,battleground,spend,fashioned,merry-go-round,refined,blonde,warned,mankind,grind,command,thousand,wand,ma-ah-hah-ah-ind,unwind,merry-go-'round,undefined,canned,second,mainland,rewind,turned,beyond,wound,learned,blend,bend,mend,spurned,crowned,frightened
L T|built,spilt,vault,fault,belt,dealt,felt
L S|panfulls,ancles,else,manacles
AH Z|juices,dollas,faces,pages,promises,fences,'cause,ideas,chances,peaches,corpses,buzz,does,kisses,sentences,circuses,causes,mommas,areas,pieces,fishes,molasses,ashes,patches,stages,oranges,sponges
L P|help
P S|pumps,cops,lips,tips,flips,dips,backups,stops,ships,hopes,whips,hips,relapse,apocalypse,chops,hops,keeps,types,fingertips,tops,mountaintops
OY S|rejoice,voice,choice
OY T|exploit,detroit
M P|pump,limp,pimp,bump,jump,damp,chimp,shrimp,stump,dump,swamp,chump,rump
P T|slapped,whipped,developed,strapped,tripped,raped,ripped,trapped,kidnapped
AW L|howl
OY Z|boys,noise,toys,boyz
NG Z|things,feelings,surroundings,beings,wings,kings,bludgeonings,songs,sings,hangs,strings,stockings,stings,brings,rings,meanings,ceilings
IY SH|leash
AE CH|match,catch,latch
OY D|void,paranoid,asteroid,destroyed
AW N|down,town,brown,greektown,motown,crown,frown,downtown,showdown,clown,uptown,gown,down-ow-own,countdown,noun,stargown,hometown
N T|basement,agent,went,bent,meant,president,lint,want,parliament,pavement,innocent,confident,point,saint,ain't,count,government,don't,cunt,vanzant,hunt,restaurant,silent,mint,event,amusement,student,gent,won't,repent,front,content,brunt,tint,permanent,malevolent,decadent,can't-,rent,plant,resident,accident,complaint,can't,didn't,expedient,relent
EY V|grave,behave,save,slave,cave,wave
NG K|rank,stank,sink,tank,bank,shrink,think,punk,hunk,drink,drunk,tonk,link,trunk,pink,frank,doublethink
OY L|oil,soil
AY N|mine,line,einstein,wine,sign,grapevine,fine,ffff-funkenstein,funkenstein,shine,whine,spine,pine,divine,serpentine,nine,twine,combine,sunshine,design,decline,porcupine,swine,999
AY L|pile,style,buckwhile,smile,file,mile,b-b-bellisle,bell-bell-bellisle,bellisle,while,i'll,reconcile,awhile,nile,vile
AW S|house,penthouse,mouse
AW T|out,doubt,about,shout,throughout,gadabout,pout,'bout,without,spout,rout
AY K|like,dike,pike,turnpike,dyke,hike,bike
ER JH|purge
AY F|life,wife,knife
F TH|25th
AY B|tribe
IY T|street,beat,seat,sweet,feet,complete,deceit,defeat,meet,neat,eat,discreet,backseat,concrete,heat,repeat,cheat,meat,incomplete,wheat,sheet,retreat,backbeat
R N|porn,born,barn,torn,worn,morn'
N AH|desdemona
AY Z|thighs,eyes,lies,realize,size,wise,guys,fries,surprise,flies,disguise,demise,cries,sunrise,highs,ties,despise,rise,skies,lullabies,alibis,compromise,socialize,guise,hypnotize,prize,tantalise,dies,depise,pies,i's,fireflies,apologise,butterflies,apologize
UH SH|tush,bush
AA R|guitar,star,jar,car,far,are,bar,flat-car,scar,superstar,afar,sonar,radar
AY T|site,transvestite,daylight,night,tonight,might,spite,kite,sight,right,uptight,fight,tight,alright,goodnight,light,bright,ignite,flight,firelight,nighty-night,fright,moonlight,candlelight,delight,appetite,bite,firefight,sunlight,midnight,moonlight',parasite,finite,white,cockfight,dynamite,unite
AY R|aspire,inspire,soundfire
AY S|nice,dice,advice,ice,twice,paradise,sacrifice,vice,suffice,price
ER TH|worth,earth,butterworth,birth
IH DH|with
IY P|steep,deep,sleep,seep,keep,asleep,creep,cheap,weep
JH D|changed,rearranged,deranged,discouraged
L IY|lickety-splitly,girly
EH|eh
UW ZH|rouge
N NG|serling
OY|boy,toy,joy,cowboy,destroy,schoolboy,ploughboy
OW|so,go,know,1-9-9-0,bronco,show,slow,flow,intro,ho,o,no,jo',low,custoe,blow,dough,hoe,snow,afro,romeo,solo,halo,bingo,oh,bo,cuervo,metro,doe,yo,rado,hollow,fellow,bordello,chicago,eldorado,bro,wino,sho',pro,grow,colorado,though,mexico,woah,calico,eskimo,undergo,flo,domino,joe,whoa,follow,window,radio,ego,co,sorrow,below,hoh,rainbow,ago,su-sussdio,sussdio,borrow,tomorrow,desperado,toe,throw,pyro,hero,stereo,whoa-oa,whoa-oa-oa,ooh-oh,hello,swallow,minnow,yoh,shadow,pillow,yellow,dobro,wa-ooh,porno,ow,widow,glo,albino,libido,sew,row,meadow,ghetto,wo-,glow,pharaoh,narrow,oh-whoa,oh-oh,ho-whoa,show-whoa-whoa-whoa,dooh,whoa-oh-oh-hoh,sako,rapido,amigo,manifesto,get-go,post-show,paso,banjo,rodeo,laddie-oh,tokyo,whoa-whoa,no-oh-oh,whoa-whoa-whoa,weirdo
AE F|half,laugh,photograph
AH SH|rush,blush,flush
R JH|george
L Z|professionals,daniels,swells,cells,halls,u-hauls,girls,steals,dangles,eels,tools,fools,daffodils,walls,souls,falls,pearls,tables,rules,dolls,troubles,poles,schools,hills,fingernails,wheels,needles,skills,bills,holes,pals,feels,curls,barrels,sails,bells,nails,shells,miles,staples,pills,ills,tolls,medals,smiles,lifestyles,marbles,devils,kills,bowels,spills,waterfalls,balls,heels,sandals
UH K|took,look,book,hook
AA|hahahaha,hah,haha,ya,da,la,ah,fa-la-la-la-la-la-la-la-la,ha,raw,ma,ahh,na,chaaaa,yeah-ha-ha,aaahh,yah,do-yeah,ah-ah-ah-ah,my-hah,ah-hah-hah,ah-hah-hah-hah,ah-ah-ah-hah,ah-ah-hah,ah-hah,ah-ah,hi-hi-hah-hah,hi-hi-hah-haaah,na-na-na-na-na-ah,na-na-na,sha-la-la-la-la-la-la,pa,ahah
AH JH|courage,knowledge,voltage
F S|photographs
UH L|full
AW CH|couch
SH T|trashed,dashed,accomplished
AW TH|mouth,south
UH D|good,neighborhood,hood,understood,could,eastwood,wood,childhood,misunderstood,would,should,stood,hollywood,minglewood
K IY|quicky
D S|cowhands,mends,resounds,skateboards
T S|basements,boots,hits,uplifts,drifts,projects,states,rats,thoughts,outskirts,hurts,streets,waits,lights,hearts,sights,heights,wants,seats,accomplishments,dates,acts,clits,armpits,let's,nights,tastes,oats,regrets,bets,nuts,bracelets,faggots,racists,beats,moments,roots,crafts,ghosts,cents,throats,notes,blankets,meets,sets,lots,exits,spirits,fists,crates,malcontents,shits,splits,parents,wrists,floats,twists,butts,guts,pants,starts,backseats,cigarettes,fruits,ingredients,rights
AA SH|wash
D Z|shades,hands,rides,lands,minds,friends,braids,roads,kids,clouds,words,cards,ends,diamonds,transcends,blades,attitudes,shreds,hoods,fields,heads,stands,woods,seconds,hummingbirds,worlds,moods,glands,fluids,overrides,bleeds,sounds,grounds,needs,steeds,swords,standards,trends,ads,hides,overlords,fades,birds,pounds,turds,crowds,thirds,child's,band-aids,amends,explodes,renegades,deeds,tides,winds,world's,presides,misunderstands,backwards,towards,seeds,backsides
UH T|put
OW N|throne,clone,own,milkbone,alone,blown,unknown,bone,mo-town,known,stone,telephone,phone,moan,brownstone,zone,shone,grown,drone,tone,lone,shown,ozone,crone,sown,cologne,trombone,flown
N JH|change,strange,range,revenge,binge,rearrange
OW L|yolllllllll,soul,control,hole,toll,roll,patrol,a-hole,roll',ol',role,pole,stroll',asshole,whole,coal,roooooll,goal
OW M|home,dome,roam,rome,ho-wome,metronome,foam
EY F|safe,chafe
OW K|joke,smoke,coke,choke,stroke
EY D|fade,aid,grade,laid,paid,made,trade,stayed,glade,afraid,parade,played,lemonade,minutemaid,shade,displayed,blade,spade,betrayed,decayed,underpaid,promenade,brigade
IY G|blitzkrieg
EY K|fake,snake,mistake,shake,make,awake,stake,take,break,headache,ache,heartbreak,handshake,quake
OW D|explode,road,load,railroad,crowed
EY N|complain,domain,pain,insane,plain,maine,brain,rain,chain,main,explain,sane,remain,cain,gain,lane,train,vein,maintain,nightrain,pane,stain,strain,cobain,zane,attain,grain,vain,humane,disdain,plane,regain,rein,cocaine,novocaine,layne,octane,aeroplane
AA D|god,tightwad,bullgod,odd,nod
EY L|ponytail,fail,nightingale,trail,prevail,jail,nail,rail,sail,shoe-tale,vail,bail,tail,whale,pale,frail
EY M|game,name,fame,shame,same,blame,frame,came,lame,dame,flame,aflame,name],claim
EY S|face,base,place,race,b-b-bass,chase,embrace,case,disgrace,space,suitcase,trace,grace,pace,staircase,erase,lace
EY P|rape,escape,tape
OW B|blow-job,globe
OW Z|potatoes,hoes,lingos,blows,hoe's,nose,pros,rhinos,goes,toes,shows,grows,shadows,knows,windows,lows,chose,those,hose,pantyhose,heroes,joe's,flows,follows,meadows,tomatoes,crinos,melrose,rose,crows
EY T|hate,plate,skate,date,masturbate,wait,straight,fate,gate,late,exultate,great,'88',state,ate,celebrate,rate,overpopulate,create,candidate,irate,concentrate,debate,stagnate,detonate,asphyxiate,emancipate
EY Z|ways,days,praise,anyways,yesterdays,daze,ablaze,haze,sideways,stays,cliches,always,phase,plays,byways,trays,holidays
OW T|wrote,vote,coat,float
OW S|close,dose
OW P|nope,dope,tightrope,hope,cope
IH N|layin,jokin,pokin,yodalin,dissin,burnin,rockin',jockin,askin,lambskin,grin,sin,sayin',pimpin',givin',livin',waxin,lookin',cookin,stylin,violin,guessin,fessin,blessin,exactin,speakin',k-i-d-r-o-c-kin,likin,hookin,understandin,movin,winnin',in,rollin',slowin,bullshittin,hittin,leapin,frownin',poundin',rumblin',stumblin',gamblin,rushin,tussin',bashin,shakin,trippin',pokin',motrin,gawkin,walkin',mackin,win,begin,frontin,revvin,sowin,growin',gin,clashin',grinnin',spinnin',sinnin',shakin',pleasin',talkin',showin',warnin',evenin',stinkin',sleepin',keepin',blowin',kin,comin',lovin',smilin',been,mornin',skin,thin,followin',dyin',tryin',within,burnin',hurtin',waitin',sneakin',thinkin',howlin',feelin',rainin',runnin',leavin',jumpin',darlin',dreamin',fuckin',chillin',wreckin',doin',barkin',turnin',smolderin',hopin',fishin',singin',a-creepin,nothin,lyin',fightin',nothin',ridin',buyin',paradin',struttin',knockin',cryin',virgin,chin,a-grin,lockin',deceivin',complainin',smokin',wearin',movin',callin',teasin',missin',risin',yearnin',beggin',goshen,foolin',schoolin',learnin',coolin',droolin',misusin',spin,blindin',shinin',climbin',denyin',findin',fallin',pumpin,pumpin',stressin,smackin',guessin',stressin',dumbin',crawlin',swimmin',dancin',freezin',bangin',bleedin',losin',cruisin',oozin',dealin',drinkin',breakin',kneelin',prayin'
IH M|him,bim,trim,dim,jim,grim,swim
IH L|till,gill,pill,bill,will,still,hill,thrill,chill,fill,kill,treadmill,spill,until,windowsill
IH K|music,pick,mc,thick,dick,sick,trick,brick,poetic,mic,slick,hick,archaic,selleck,stick,rick,quick,tragic,elastic,magic,manic,panic,attic,sic,tactic,melodramatic,pornaholic,heretic,lipstick,chick,tunic,anaesthetic,copaseptic
R D|sword,obscured,hard,lord,weird,backyard,prepared,scared,ford,yard,assured,stared,card,bored,shared,guard,scarred,cured,barred,appeared,aboard,accord,record,shard,endured,reward,adored,cared,ripcord,blackboard
R G|morgue
R F|arf
IH G|dig,big
IH F|if,stiff
R K|bark,park,dark,spark,pork,york
IH D|hid,kid,did,infatuated,fronted,busted,cremated,incarcerated,blooded,x-rated,g-rated,suffocated,branded,overrated,ousted,rewarded,costed,wilted,winded,unbended,unguarded,mistreated
IH C|rustlic
IH JH|college,advantage,carriage,marriage
IH NG|swing,seeing,boosting,feeling,nothing,sperling,stealing,hustling,going,sing,sting,thing,shotgun-blasting,morning,meaning,soaking,king,darling,amusing,confusing,losing,something,everything,dawning,bawling,redeeming,ceiling,crying,talking,walking,falling,happening,killing,constructing,trying,planning,changing,spinning,questioning,drowning,warning,howling,lightning,dying,shining,beginning,knowing,believing,cheating,waiting,saying,coming,hiding,misunderstanding,chugging,hugging,working,flying,standing,ring,wing,anything,living,loving,trembling,jumping,wasting,tasting,missing,co-operating,a-falling,crumbling,offering,burning,winning,saving,fling,running,listening,swallowing,hallucinating,begging,suffering,watching,pretending,string,screaming,rising,a-blowing,overflowing,turning,shaking,taking,eating,needing,forgiving,worrying,laughing,masturbating,hating,dreaming,thinking,wondering,rotting,whining,sitting,quitting,lifting,drifting,disbelieving,pounding,wandering,doing,surrounding,hounding,mounting,a-flowing,fighting,frightening,giving,tearing,calling,crushing,lying,weakening,gathering,smiling,shouting,winding,programming,unfolding,flowing,complaining,kissing,ringing,winging,singing,banging,ying,bleeding,receding,infesting,breathing,healing,freezing,craving,heading,darkening,brewing,dissing,dogging,blessing,reckoning,biding,fucking,depressing,clamoring,spring,marking,leaving,learning,casting,dissolving,revolving,gleaming,mourning,dancing,ling,praying,romancing,knocking,dazzling,colouring,barking,evening,yawning,reeling,aching,playing,breaking,whispering,overtaking,counting,hurting,misleading,visiting,raising
AA N|on,amazon,moron,upon,john,iran,tehran,hienton,baton,gibran,khan,c'mon
R S|remorse,fierce,horse,source,discourse,force
EY|say,way,away,r-o-c-k,rca,display,cliche,jay,lay,everyday,hey,heeeeeeeeeey,ok,sunday,delay,anyway,day,today,pray,stay,pay,holiday,chevrolet,okay,they,yesterday,play,grey,gray,someday,faraway,fe,stray,highway,astray,usa,a--,gay,freeway,mca,clay,doorway,gateway,skyway,hay,yay,yea,dayayayay,sleigh,bay,obey,prey,betray,survey,array,baby-ay,just-a,damna-,today-ay-ay,dj,thursday,disarray,decay,may,this-a-way,alleyway,birthday,runaway,ray,motorway,halfway
IH Z|douches,bitches,backwashes,draggin,is,aces,roses,excuses,senses,eclipses,romances,sages,cheeze-whiz,biz,wishes,is-,noises,challenges,crashes
CH T|touched,clenched,patched
IH V|positive,give,forgive
IH T|it,shit,quit,skit,bit,hit,pomagranite,pit,favourite,fit,split,faget,clit,'shit',desperate,locket,permit,bullshit,tit,spit,exit
IH S|diss,this,levis,kiss,miss,paris,bliss,piss,gingivitis,reminisce,solstice,lewis
IH R|clear,peer,beer,frontier,disappear,fear,dear,year,near,unclear,chandelier,bombardier,queer,deer,sear
IY CH|each,beach,reach,teach
ER|backpacker,weedwacker,together,wilbur,silver,brother,lover,heartbreaker,maker,thunder,mother,under,fucker,faker,motherfucker,sucker,her,over,rover,matter,holster,poster,announcer,ouncer,presser,professor,cheaper,talker,hooker,empire,never,glitter,hitter,hooter,shooter,skipper,tripper,lancer,camper,cramper,wonder,unger,redder,sweater,damper,higher,slower,player,loner,boner,figure,stranger,ranger,color,crapper,clapper,glover,undercover,rapper,river,forever,letter,desire,future,meister,elevator,culture,sculpture,blinder,power,platter,torture,pleasure,deadlier,stir,picture,ever,answer,hour,remember,harder,better,number,cover,paper,corner,younger,danger,dancer,flyer,other,border,order,refrigerator,rider,longer,stronger,tiger,altar,faster,fire,fighter,pyre,behavior,savior,pacifier,another,after,neighbour,poindexter,choir,monger,closer,liar,insecure,neighbor,failure,lower,occur,sugar,water,flower,clearwater,weather,dollar,walker,mister,sir,sister,shoulder,whenever,chamber,consider,burner,soldier,harbor,center,thicker,clover,warmer,master,laughter,mirror,lucifer,ladder,older,later,cracker,clearer,slicker,licker,deceiver,bleeder,locker,favor,screamer,cellar,hammer,moneymaker,spencer,nearer,deliverer,destroyer,cower,weaker,glamour,bower,architecture,anger,ishkur,father,disorder,sweeter,writer,partner,tighter,colour,doctor,monster,reefer,refer,pressure,proper,scarier,hairier,devour,sicker,suffer,cocksucker,vinegar,fodder,stutter,hauser,louder,slither,sever,shelter,sinner,killer,tougher,speaker,marker,barter,daughter,sponsor,tower,temper,sender,alligator,trigger,leather,sunflower,cheshire,lavender,flavour,watcher,fever,further,stripper,finger,singer,nature,wire,rocker,roller,controller,wheeler,dealer,stealer,bruiser,cruiser,hummer,sour,preacher,feller,junketer,trumpeter,leader,tender,discover,adventure,error,tire,surrender,vancouver,honor,teacher,feather,rearviewmirror,former
AA M|calm,palm,bomb,vietnam,stepmom,prom,mom
R P|sharp
UW|laheeeeoooooooo,laheeeooooo,laheoooo,laheoooooo,yoollllooo,crew,lahehoooo,yodalahehoooooooooo,to,glue,igloo,you,through,do,avenue,cashew,new,canoe,brew,kangaroo,buckaroo,too,2,sue,true,tattoo,ooh,dew,due,yoodle-eh-hi-hoo,view,knew,shoe,blue,voodoo,who,doo,two,into,q,bayou,lou,you-know-who,chu,boo,loew,ooh-ooh-ooh,untrue,few,to-,oo,hoo,withdrew,virtue,blew,clue,grew,coochie-coo,loo,dodododododododododo,ooh-ooh-ooh-ooh-ooh,n'doo,renew,timbuktu,wooh,whew,queue,zoo,whoo,woo,continue,venue
B Z|robes,clubs,flashbulbs
N TH|month
IY K|speak,weak,freak,creek,cheek,beak,week,squeak
B D|robbed
AE V|have
B L|unconceivable
Z IY|floozy
R T|part,chart,k-mart,start,sweetheart,heart,apart,sport,abort,short,resort,airport,support
AE S|ass,bass,class,grass,pass,gas,glass,mass,overpass
AE P|strap,flap,crap,rap,slap,snap,trap,burlap,bitch-slap,lap
L F|wolf,myself,itself,self,yourself,herself,himself,shelf
AE T|that,at,cat,format,rat-a-tat-tat,comosat,gat,rat,habitat,flat,hat,fat
F T|soft,gift,left,swift,shift,scoffed
AE Z|has,jazz,as
AE NG|bang,slang,hang,lang,dang,gang,sang,doomerang,yang
R V|starve
M Z|rhymes,times,slams,gems,stems,dreams,sometimes,games,seems,arms,names,dimes,bombs,flames,williams,pilgrims,thumbs,hymns,crumbs,seams,homes,schemes,comes,charms,adams,uniforms,problems,beams,chimes,screams
AE B|cab,slab,tab
M D|seemed,unclaimed,damned,tamed,formed,shamed,ashamed,maimed,blamed,armed
K S|tricks,seeks,slacks,wax,sticks,kicks,reebox,lakes,box,critics,chicks,stakes,breaks,stalks,works,politics,tracks,takes,trucks,axe,relax,sakes,checks,sex,fifty-six,fucks,rocks,spikes,fix,seljuks,automatics,sucks,aches,likes,climax,folks,looks,socks,books,66,walks,bakes,speaks,phoenix,mistakes
K T|rocked,worked,jerked,fact,fucked,sucked,respect,act,react,extinct,expect,contract,instinct,baked,product,looked,choked,suspect,talked,conflict
AE G|bag,fag,drag,wag,shag,rag,flag
AE D|nomad,had,sad,glad,bad,dad,lad,mad,baghdad
UH R|sure,secure,you're,unsure,cure,pure,endure,poor
AE K|back,mac,black,kojak,track,feedback,jack,sack,mack,crack,stack,cadillac,whack,smack,maniac,attack,razorback,pack,quack
AE N|man,tarzan,plan,can,dan,japan,ran,than,began,spaceman,po-o-ostman,mailman,sun-tan,ray-ban,pan
AA L|doll,alcohol
AE L|corral,gal,mal
AE M|program,jam,am,damn,goddamn,slam,5-ham,ham
V D|uparrivd,loved,enslaved,served,removed,deceived,waved,shaved,survived,saved,involved
R Z|tears,cares,stares,ears,fears,stars,pours,appears,yours,wars,there's,years,floors,bars,mars,queers,cigars,swears,disappears,wears,stairs,doors,nears,affairs,scars,dares,troubadours,stores,prayers,cars,theirs
AH NG|toungue,tongue,young,hung,sung,stung,lung,rung
EH TH|death,breath
DH D|unscathed,breathed
UW D|rude,solitude,crude,food,unglued,mood,glued
AA CH|watch
AO N|gone,lawn,dawn,pawn
EY TH|faith
IH P|relationship,zip,sip,hardship,rip,whip,strip,lip,dip,hip,friendship,slip
T IY|peyote,s'ti,tnt
V Z|lives,ourselves,curves,leaves,graves,themselves,chives,believes,moves,knives,fives,gloves
L D|world,old,gold,wild,child,threshold,mold,hold,cold,field,told,failed,snarled,shield,killed,prevailed,fulfilled,unfold,tailed,new-fangled,rock-and-rolled,hurled,sealed,smiled,sold,gerald,defiled
AO NG|wrong,along,song,long,strong,belong,everlong
IY F|leaf,thief,relief,grief
AY V|jive,alive,live,strive,'55,arrive,dive,survive,five,forty-five,1985,hive,thrive,drive
K TH|strength
ER B|curb
AO F|off
AO G|dog,sweathog,log
UW V|groove,prove,move
IY OW|su-sussudio
IY V|believe,leave,sleeve,weave,naive,eve,conceive,deceive,achieve
AA T|alot,shot,caught,not,hot,lot,got,bought,pot,rot,forgot,slot
IY R|here,ear,hear,shakespeare
IY S|peace,cease,piece,police,increase,release
AA P|stop,top,hop,pop,flop,drop,cop,shop,chop
IY Z|titties,booties,cuties,jammies,grammies,fannies,mp's,please,slimmys,jimmys,80's,90's,sees,trees,keys,abilities,memories,disease,breeze,knees,melodies,bodies,benji's,posies,fantasies,junkies,luxuries,squeeze,ease,louise,enemies,families,biddies,these,companies,centuries,bees,denny's,babies,prophecies,deficiencies,city's,seas,realise,alleys,d's,bullies
AA F|cough
AA G|fog
IY D|guaranteed,speed,bleed,need,succeed,breed,seed,greed,plead,indeed,tumbleweed,worried
AA NG|lo-ooh-ong
AA B|slob,job
UW DH|smooth
IY N|clean,seen,scene,mean,nineteen,green,13,dean,magazine,josephine,queen,obscene,machine,screen,lean,unseen,guillotine,between,bean,avaline,eva-iva-ova-avaline,evaline,seventeen,eighteen,gasoline,tambourine,fourteen,sixteen,eileen,tangerine,jean,unclean,thirteen
AA Z|was,cause
IY L|kneel,heal,real,feel,wheel,steal,deal,peel,o'neal,steel,seal,unreal,ordeal,surreal,she'll,dweel
IY M|beam,gleam,steam,dream,seem,cream,downstream,scream,stream,theme
AA K|rock,block,shock,cock,dock,iraq,clock,hock
ER CH|church,search
UW L|cool,pool,fool,school,ridicule,rule,minuscule
UW M|bloom,tomb,room,doom,perfume,gloom,presume,bedroom,broom,boom,bathroom
UW N|cartoon,soon,spoon,goon,moon,tune,june,'coon,saloon,afternoon,swoon,immune
AO K|talk,hawk,walk
AO L|wall,all,recall,fall,call,hall,ball,tall,cannonball,squall,y'all,small,waterfall,stall,crawl
EH M|mayhem,them,bethlehem
G Z|fags,mags,dogs,bags,kegs,tags,legs
EH S|less,success,stress,express,yes,address,guess,dress,recess,mess,abscess,bless,progress
EH R|stare,care,there,air,everywhere,hair,anywhere,tear,nowhere,aware,bear,somewhere,share,lair,chair,underwear,bare,ev'rywhere,where,prayer,unfair,scare,heir,fair,rare,dare,compare,wear,pair,declare,nightmare,millionaire
UW F|roof
EH P|yep,step,doorstep
AO D|fraud
UW B|cube,scoob,tube
EH T|wet,bet,jet,get,set,sweat,cigarette,regret,forget,met,upset,yet,bett-,sunset,debt
EH K|deck,neck,check
AO Z|because,doz,draws
AY M|dime,rhyme,time,prime,dime-,lifetime,crime,sometime,i'm,anytime,wintertime,overtime,chime,summertime,lime,climb
AW Z|vows,cows,allows
EH N|men,when,10,again,then,ten,pen,chien,'gain,den,businessmen
UW Z|dues,shoes,issues,lose,choose,news,blues,refuse,reviews,fuse,revues,booze,tattoos,cruise
EH L|sell,well,bell,tell,cell,shell,hell,fell,swell,michelle,citadel,smell,dwell,spell,motel,farewell
UW T|hoot,cute,shoot,fruit,suit
UW TH|truth,youth
AO R|more,floor,store,for,gore,whore,uproar,war,door,anymore,your,or,before,bore,four,shore,forty-four,thor,wore,explore,sore,adore,core,oar,ashore,abhor,swore,nevermore,wherefore
S IY|wussy,sassafras-y
AO T|fought,taught,thought,forethought,brought
EH F|stef,deaf
UW S|loose,juice,use,noose,abuse,excuse
AO S|cross,loss,moss
AY D|side,stride,applied,plied,upside,upsideeeeeeeee,ride,died,homicide,seaside,aside,outside,cried,inside,collide,hide,confide,pride,suicide,tied,tried,lied,oversimplified,justified,mystified,decide,satisfied,brightside,eastside,tide,countryside,wide,infanticide,genocide,exemplified,denied,pesticide,riverside,dried,glorified,guide
EH Z|says
EH G|beg,leg
IY DH|breathe,seethe
EH JH|edge
EY JH|cage,age,rage,stage
R OW|quatro
EH D|said,head,dead,red,forehead,bed,fed,ahead,instead,shed,spoon-fed,led,cornbread,lead,bread,dopehead,dread,tread,bedspread,drug-head,watershed,flowerhead,bled,fred,underfed,thread,well-fed
HH UW|yodalaheho
IY|valley,me,coochie,sushi,frisky,whiskey,story,tacky,happy,yodalahe,hehe,yummy,party,funny,heavy,steady,lp,taxi,pretty,city,cali,somebody,money,nasty,duty,booty,gucci,see,vd,goody,puddy,dickie,sticky,fanny,granny,pussy,annie,baby,forty,naughty,kdc,seriously,uniquely,three,jersey,thee,fruity,authority,industry,gotti,free,key,posse,be,honey,crazy,g,d,oakley,coyote,linely,homely,tree,easy,meeeee,unity,93,p,vitale,disagree,lsd,pesky,dusty,crusty,body,sea,saturday,memory,melody,navy,billy,seine,history,she,lordy,holly,jolly,flea,virginity,we,lately,dirty,tragicomedy,university,domine,sorry,eternity,reality,family,early,mentally,physically,misery,empty,worry,slowly,mary,lonely,ready,really,hurry,everybody,many,any,weary,maybe,movie,lucky,glory,legacy,antone,quickly,holy,only,sally,alley,ooh-wee,knee,teddy,monday,bee,destiny,plea,tightly,nightly,mercy,enemy,prophecy,debauchery,casualty,democracy,obscurity,lapd,endlessly,nobody,celebrity,agree,pity,buddy,funky,monkey,wannabe,lady,daddy,ice-t,friday,gloomy,harry,conspiracy,tuesday,closely,mississippi,badly,tennessee,shitty,gritty,gypsy,fantasy,tea,eventually,sanity,carelessly,helplessly,rosie,country,lazy,tv,jealousy,gently,sanctuary,loyalty,security,shady,nosy,bloody,contrary,katie,albuquerque,penny,sassy,already,tallahassee,dignity,mystery,me-,patiently,company,safety,agony,stupidity,battery,potency,insanity,energy,flurry,conformity,honesty,wednesday,society,fecundity,infertility,khaki,tommy,army,deeply,lobotomy,mm-baby,b-ba-baby,philosophy,noisy,frenzy,lovely,insecurity,ruby,ninti,tragedy,majesty,courtesy,brutality,activity,therapy,me-e,madly,junkie,putty,study,icky,broccoli,clearly,negativity,grimy,stimey,raspy,angry,guilty,filthy,profanity,horny,morality,blasphemy,purity,ugly,catastrophe,revelry,slightly,sloppy,he,impatiently,ordinary,lily,used-to-be,indeed-ee,z,tardy,lacy,naturally,jewelry,balcony,refugee,remedy,beanery,ability,boogie,mercury,fancy,chile,suddenly,glee,viciously,yippee,emily,hobby,sweetly,emergency,guarantee,carefully,facsimile,v,hungry,vanilli,andy
EY B|babe
IH SH|dish
S K|ask,disc,grotesque,mask
AE|yeah,yeah-yeah,uh-yeah,a-swing~eah-yeah~yeah,ooh~yeah,a-yeah
AH|huh,the,uh,oprah,criteria,buddha,a,dah,cheetah,california,virginia,oklahoma,nevada,aroma,lisa,america,gloria,china,arizona,mama,alabama,papa,wanna,yowsa,idea,val-hala,madonna,nirvana,memoria,pandora,aura,suh,metallica,militia,messiah,ah-ah-ah-da-da,need-a,satisfied-a,anna,pneumonia,sucka,pecka',malaria,umbra,arena,vitae,momma,duh,paramania,kimono,bandana,montana,mamma,aiyah,gonna,magnolia,fella,mona,miranda,uh-huh
AE TH|scrath,path,bath,math
S D|dissed
Z D|surprised,confused,exposed,hypnotized,paralyzed,used,disguised,abused,unrealized,closed,realized,pleased,fused,raised
AO|jigsaw,law,saw,chainsaw,haw,aw,jaw
AH CH|much,touch,clutch,such
DH Z|clothes,mouths,breathes
R TH|forth
AW|now,how,allow,somehow,anyhow,-ow,plough,cow,wow,thou,sow,pow
AY|my,high,k-i-,i,goodbye,sigh,by,fly,pie,try,why,sky,dry,cry,july,eye,thigh,die,lie,lullaby,bye-bye,bye,alibi,justify,good-bye,shy,buy,occupy,guy,deny,multiply,nullify,calcify,eye-to-eye,rectify,tie,fry,fie,rhye
N CH|bunch,bench,cinch,inch,pinch,clinch,flinch,branch,wrench
S T|obsessed,undressed,forest,tourist,first,rehearsed,midwest,hardest,largest,adjust,rust,dust,list,kissed,artist,best,contest,cost,rest,chest,bust,sexist,breakfast,next,fessed,novelist,worst,pissed,twist,protest,waste,test,erased,exist,missed,past,beast,coast,convinced,just,sacrificed,last,resist,fast,lust,lost,frost,thirst,blessed,taste,faced,distrust,passed,possessed,existentialist,christ,post,priest,east,increased,roast,trust,most,against,bounced,blast,infest,fist,brightest,ghost,waist,west,introduced,diagnosed,breast,se,crust,misplaced
EY G|plague,vague
EH CH|stretch
TH S|depths,months,psychopaths,deaths
ER D|word,wandered,heard,cupboard,mattered,altered,shattered,wondered,battered,bird,herd,bastard,self-assured,tired,bluebird,tortured,covered,gathered,standard,wired
AO M|pom
EH SH|flesh,fresh
ER K|jerk,work,clockwork
ER M|worm
ER L|girl,merle,curl
R CH|arch,torch,porch
ER N|learn,burn,return,turn,concern
ER S|worse,universe,purse,disperse,verse,curse
T AH|lo-lo-lo-lolita,artista
R M|form,storm,harm,charm,platform,arm,farm,warm,disarm,alarm
ER T|shirt,pervert,sweatshirt,discomfort,hurt,skirt,desert,dirt
ER V|nerve,serve,deserve,reserve
EY AH|today-a
AW D|loud,cloud,crowd,proud,endowed,allowed,aloud
ER Z|adventures,denchers,suckers,motherfuckers,niggers,struthers,answers,sinners,leaders,letters,rumours,strangers,others,soldiers,elders,wanders,jugglers,ours,numbers,visitors,walkers,swampers,brothers,trousers,flowers,liners,fingers,colors,mirrors,courtiers,sailors,covers,spurs,comers,hours,non-believers,orders,matters,refrigerators,desires,lovers,neighbors,peppers,picutres,speakers,barriers,blisters,waters,tatters,shatters,mothers,losers,preachers,unbelievers,councilors,senators,counselors,riders,prisoners,papers,flavors,pictures,leftovers,fires
AY P|pipe,wipe,stereotype,type
IY TH|teeth
